__________
_TT_______
__T___T___
_XT___T___
____T_____
__________